9 9 20 3 5 
0 0 2 2 2 0 2 0 0
2 4 4 4 4 4 4 4 2 
2 4 4 4 1 4 4 4 2 
2 4 4 3 3 4 4 4 2 
2 4 4 4 4 4 4 4 2 
2 4 4 4 4 4 4 4 2 
2 4 4 4 4 4 4 4 2 
2 4 4 4 4 4 4 4 2 
2 2 2 2 2 2 2 2 2 
